vitor - silencio dos inocentes
eduardo - rei leao
beatriz f. - psicose
heitor - anticristo
beatriz a. - cisne negro
nicholas - metropolis
gabriele - laranja mecanica
ricardo s. - titanic
beatriz o. - brilho eterno de uma mente sem lembrancas
marilia - diario da princesa
mateus - narnia
thais - dream girls
nathalia l. - trainspotting
priscila - jumanji
arthur - whiplash
mariah - harry potter
fabricio - a chegada
leticia - donnie darko
alef - django livre
nathan - dr. estranho
ricardo r. - fargo
alexander - 12 macacos
natalia r. - pequena sereia
gabriel - toy story
erika - a viagem de chihiro
giovanna - enrolados
maria - evil dead
fernanda - labirinto do fauno
laice - cartas para julieta
heloiza - a origem
