ENTREGA: 19/JUNHO

LIVROS
Fabricio - Perdido em Marte
Vitor - Duna
Matheus - O Nome do Vento
Nathalia Lino - O Filho do Éden
Priscila - Frankenstein
Thais - Cinder
Arthur - Neuromancer
Nicholas - ASOIAF
Fernanda - Eu robô
Mariah - Ready player one
Alef - o Aleph
Ricardo Romanos - Admirável Mundo Novo

- Super brinquedos duram o verão todo




MUSICAS
Beatriz Oliveira - Jeremy
Maria - Disorder
Gabriel - Living on a prayer
Beatriz Alegre - A horse with no name
Ricardo Souza - Man in the mirror
Beatriz Furlanetto - Starman
Marília - Hotel California
Letícia - Ghost town
Heitor - Welcome home sanitarium
Gabrielle - Lucy in the sky
Giovanna - Trem das 11
Laice - Eduardo e mônica
Heloiza - Space Oddity
Natalia rodrigues - 5 Patinhos

- MMMMM MMMM MMMMM
- Like a rolling stone
- Basket case
- Pato Marreco
- Plunct, Plact, Zum
